Nelson
1111111111
1000000001
1000000001
1000000001
1000000001
1000000001
1000000001
1000000001
10000000R1
1111111111
