Nelson
1111111111
10R0000001
1000000001
1000000001
1000000001
1000000001
1000000001
1000000001
1000000001
1111111111
