Nelson
1111111111
1000000001
1000000001
1000000001
1000000001
1000R00001
1000000001
1000000001
1000000001
1111111111